+-+-+-+-+-+-+-+-+-+-+-+-+-+-+-+-+
|                               |
+ +-+-+ +-+-+-+-+-+-+-+ +-+-+-+ +
| |     |       |       |     | |
+ +-+-+-+ + + +-+-+ + +-+ + +-+ +
|   | |   | |     | |     |   | |
+ + + +-+ + + + + + +-+-+-+-+ + +
| |   |   | | | | | | | |     | |
+ + + + + + + +-+ + + + + +-+-+ +
| | |   | | |   |   | |   |   | |
+ +-+ + + +-+-+ +-+ + + +-+ + + +
|   | | |     |   |   | |   | | |
+ +-+ +-+-+ +-+-+ +-+-+ + +-+ + +
| |     | |     |     |   |   | |
+ + +-+-+ +-+ +-+-+ + +-+-+ +-+ +
| |       | | |   | |         | |
+ + + +-+ + + + + +-+-+-+-+-+ + +
| | |   | |   |         |     | |
+ + +-+ + +-+-+-+-+-+-+ + +-+-+ +
| | | | | |     | |   |   |     |
+ + + + + +-+ +-+ +-+ +-+ + +-+ +
| |   |       |   |       |   | |
+ +-+ + +-+-+ +-+ + +-+-+-+-+ + +
|           |   |   |         | |
+ +-+-+ +-+-+ +-+ +-+ +-+ +-+ + +
| |     |       | |   |   | | | |
+ + +-+ + +-+-+-+ + +-+ +-+ + + +
| | |   | |   |   | |       | | |
+ + + +-+ +-+ + +-+-+ +-+-+-+ + +
| | | |   |     |               |
+ + + + +-+-+-+-+-+-+-+-+ +-+-+ +
| |   |                         |
.-+-+-+-+-+-+-+-+-+-+-+-+-+-+-+-+
