+-+-+-+-+-+-+-+-+-+-+-+-+-+-+-+-+
| |                           | |
+ +-+-+-+-+-+ +-+-+-+ +-+-+ + + +
|             |     | | | | | | |
+ +-+ + +-+ + +-+ + +-+ + +-+ + +
|   | | |   | | | |     |       |
+ +-+-+ +-+ + + +-+-+ + + +-+-+ +
|   | |   | | |   | | |   | | | |
+ +-+ + +-+ + +-+ + + +-+-+ + + +
|     | |   | | |   |       |   |
+ +-+ + +-+ +-+ + +-+-+-+-+ + +-+
| | | | |   |     | |   | |     |
+ + + + + +-+ +-+ + +-+ + +-+-+ +
| | |   | |     |   |       |   |
+ + + + +-+ +-+-+-+ + +-+ + + + +
| | | | |   | |   | | |   |   | |
+ + + +-+-+ +-+ + + + + +-+ +-+ +
| |   |   |   |   | | | |   |   |
+ +-+-+ + +-+-+ +-+ + + +-+ +-+ +
|       | |   | |     |   |   | |
+ +-+-+ + + + + +-+ + +-+ +-+ + +
| |     | | | |     |   |   |   |
+ + +-+-+-+ + +-+-+-+-+ +-+ +-+ +
| |         | |           |     |
+ +-+-+-+ + + + +-+-+-+ + +-+-+ +
| |       |   | |       | |   | |
+ + +-+-+-+-+-+-+-+-+ +-+ + + + +
| |       | |             | | | |
+ +-+-+-+ + + +-+-+-+-+-+-+-+ + +
| |       | |                 | |
+ + +-+-+-+ +-+-+-+-+-+-+-+-+ + +
| |                             |
.-+-+-+-+-+-+-+-+-+-+-+-+-+-+-+-+
