+-+-+-+-+-+-+-+-+-+-+-+-+-+-+-+-+
| |                             |
+ + + +-+-+-+-+-+-+-+-+-+-+ + +-+
|   | |       |                 |
+ +-+ + +-+-+ + +-+-+ + + +-+-+ +
|     | |   |   |   |   |       |
+ +-+ + + + +-+-+ + +-+-+-+-+ + +
|     |   |                     |
+ +-+-+-+-+-+-+-+-+-+-+-+ + +-+ +
| |   |   |     |               |
+ + + +-+ + + + + + + + +-+-+ + +
| | |   |   | |     |   |       |
+ + +-+-+-+-+-+-+-+-+-+-+-+ +-+ +
| |   |     |       |   |       |
+ +-+ + + +-+ + +-+ + + +-+ +-+ +
| |   | |   | |                 |
+ + +-+ +-+ + + + +-+-+-+-+ +-+ +
| | |   |   | |     |           |
+ + + +-+ +-+ +-+-+ + + +-+-+-+ +
| |   |     |                   |
+ +-+-+ +-+-+-+-+-+-+-+-+-+-+ + +
| |     |   | |     |           |
+ + + + + + + + + + + + + + + + +
| |   |   |     |       |       |
+ +-+ + +-+-+ +-+-+ +-+ + +-+ + +
| |   |   | | |     |   |       |
+ + + + + + + + + + + + + + + + +
| | |     |     |       |       |
+ + + +-+-+ +-+-+-+-+-+ + + + + +
|   | | | |                     |
+ + + + + + + + + + + + + + + + +
| |                             |
.-+-+-+-+-+-+-+-+-+-+-+-+-+-+-+-+
