+-+-+-+-+-+-+-+-+-+-+-+-+-+-+-+-+
|                               |
+ +-+-+-+-+-+-+-+-+-+-+-+-+-+-+ +
| |                             |
+ + +-+-+-+-+-+-+-+-+-+-+-+-+-+ +
| | |                           |
+ + + + +-+-+ +-+-+-+-+-+-+-+-+ +
| | | |     |       | |   |     |
+ + + +-+-+ +-+-+-+ + + + + + + +
| | |       |       | | | | | | |
+ + + +-+ +-+ +-+-+-+ + + + +-+ +
| | | |     |         | | |   | |
+ + + + + +-+-+-+-+-+ + + +-+ + +
| | | | | | |       | | | |   | |
+ + + + +-+ + +-+-+ + + + + +-+ +
| | | |   | | |   | | | | |   | |
+ + + +-+ + + + + + + + + +-+ + +
| | | |     |     | |   |   | | |
+ + + + +-+ + +-+-+ + + +-+ + + +
| | | | |   |       | |   |   | |
+ + + +-+ + +-+-+ +-+-+ + +-+ + +
| | | |   | | |   |   | |   | | |
+ + + + + +-+ + +-+ + +-+-+ +-+ +
| | | | | | |   |   | |       | |
+ + + + +-+ + +-+ +-+ +-+-+-+ + +
| | | |     |       | |   |   | |
+ + + +-+ +-+-+-+-+-+ + + + + + +
|   | |                 |   | | |
+ + + +-+-+-+-+-+-+-+-+-+-+-+ + +
| | |                         | |
+ + +-+-+-+-+-+-+-+-+-+-+-+-+-+ +
| |                             |
.-+-+-+-+-+-+-+-+-+-+-+-+-+-+-+-+