+-+-+-+-+-+-+-+-+-+-+-+-+-+-+-+-+
|   |   |                       |
+-+ + + + +-+-+-+-+-+-+-+ +-+ +-+
| |   | | |               | | | |
+ + +-+ + + +-+-+-+-+-+-+ +-+ +-+
|     |   |                     |
+ +-+ +-+-+-+-+ +-+-+-+-+-+-+ +-+
|   | |                   | | | |
+ +-+ + +-+-+-+-+-+-+-+ +-+-+ +-+
| |   |   |   |   |   |   |     |
+-+ + +-+ + + + + + + +-+ + +-+ +
|   | |   |     |   | |   | | | |
+ +-+ + +-+ + +-+-+-+ + +-+ +-+ +
| |   |   | |       | |   |     |
+ +-+ +-+ + + +-+-+ + +-+ + +-+ +
|   | |   | | |     |     |     |
+ + +-+ +-+ + + + + + + +-+-+ +-+
| |   |     | |   | | |   |     |
+ +-+ +-+ + + +-+-+ + +-+ + +-+ +
|   | |   | |       | |   |     |
+ +-+ + +-+ +-+-+-+ + + +-+ +-+ +
| |   |   | |   |   | |   | | | |
+-+ +-+-+ + + + + + + +-+ + +-+ +
|   | |   |   |   |   |   |     |
+ +-+ + +-+-+-+-+-+-+-+ +-+-+ +-+
| |   |                   | | | |
+ +-+ +-+-+-+-+-+ +-+-+-+-+-+ +-+
|   |           |               |
+ + +-+ +-+ +-+ + +-+-+-+ +-+ +-+
| |   | | |   | |         | | | |
+ +-+ + + +-+ +-+-+-+-+-+ +-+ +-+
| |         |                   |
+-+-+-+-+-+-+-+-+-+-+-+-+-+-+-+-+
