+-+-+-+-+-+-+-+-+-+-+-+-+-+-+-+-+
|   |   |                       |
+-+ + + + +-+-+-+-+-+-+-+ +-+ +-+
| |   | | |               | | | |
+ + +-+ + + +-+-+-+-+-+-+ +-+ +-+
|     |   |                     |
+ +-+ +-+-+-+-+ +-+-+-+-+-+ +-+ +
|   | |                   | | | |
+ +-+ + +-+-+-+-+-+-+-+ +-+ +-+ +
| |   |   |   |   |   |   |     |
+-+ + +-+ + + + + + + +-+ +-+ +-+
|   | |   |     |   | |   | | | |
+ +-+ + +-+ + +-+-+-+ + +-+-+ +-+
| |   |   | |       | |   |     |
+ +-+ +-+ + + +-+-+ + +-+ + +-+ +
|   | |   | | |     |     |     |
+ + +-+ +-+ + + + + + + +-+-+ +-+
| |   |     | |   | | |   |     |
+ +-+ +-+ + + +-+-+ + +-+ + +-+ +
|   | |   | |       | |   |     |
+ +-+ + +-+ +-+-+-+ + + +-+-+ +-+
| |   |   | |   |   | |   | | | |
+-+ +-+-+ + + + + + + +-+ +-+ +-+
|   | |   |   |   |   |   |     |
+ +-+ + +-+-+-+-+-+-+-+ +-+ +-+ +
| |   |                   | | | |
+ +-+ +-+-+-+-+-+ +-+-+-+-+ +-+ +
|   |           |               |
+ + +-+ +-+ +-+ + +-+-+-+ +-+ +-+
| |   | | |   | |         | | | |
+ +-+ + + +-+ +-+-+-+-+-+ +-+ +-+
| |         |                   |
+-+-+-+-+-+-+-+-+-+-+-+-+-+-+-+-+
